0000000000000000000000000000000000
0..........00000000000000000000000
0..........00000000000010000000000
0..........00000000000010000000000
0..........00000000000010010000000
0..........00000000111111111110000
0..........00000000100010010000000
0..........00000000100010010000000
0..........00010000111111111000000
0..........00010000100010010000000
0..........01010000100010000000000
0000000000001010000100000000000000
0000001111111111111110000000000000
00000000100010100001000..........0
00000000100010100001000..........0
00000000100010100001000..........0
00111111111110100001000..........0
00000000100010111111000..........0
00000000100000100001000..........0
00000000000000100001000..........0
00000000011111100001000..........0
00000000000000000001000..........0
00000000000000000000000..........0
0000000000000000000000000000000000